"filename", "language", "XML", "YAML", "Batch", "Java Properties", "Java", "comment", "blank", "total"
"d:\java_project\java-learning-travel-demo\springboot-blog\.mvn\wrapper\maven-wrapper.properties", "Java Properties", 0, 0, 0, -2, 0, -16, -1, -19
"d:\java_project\java-learning-travel-demo\springboot-blog\mvnw.cmd", "Batch", 0, 0, -102, 0, 0, -51, -36, -189
"d:\java_project\java-learning-travel-demo\springboot-blog\pom.xml", "XML", -38, 0, 0, 0, 0, 0, -4, -42
"d:\java_project\java-learning-travel-demo\springboot-blog\src\main\java\com\wendy\springbootblog\SpringbootBlogApplication.java", "Java", 0, 0, 0, 0, -9, 0, -5, -14
"d:\java_project\java-learning-travel-demo\springboot-blog\src\main\resources\application.properties", "Java Properties", 0, 0, 0, 0, 0, 0, -2, -2
"d:\java_project\java-learning-travel-demo\springboot-blog\src\test\java\com\wendy\springbootblog\SpringbootBlogApplicationTests.java", "Java", 0, 0, 0, 0, -9, 0, -5, -14
"d:\java_project\java-learning-travel-demo\springboot-learning\.mvn\wrapper\maven-wrapper.properties", "Java Properties", 0, 0, 0, 2, 0, 16, 1, 19
"d:\java_project\java-learning-travel-demo\springboot-learning\mvnw.cmd", "Batch", 0, 0, 102, 0, 0, 51, 36, 189
"d:\java_project\java-learning-travel-demo\springboot-learning\pom.xml", "XML", 42, 0, 0, 0, 0, 0, 5, 47
"d:\java_project\java-learning-travel-demo\springboot-learning\src\main\java\com\wendy\SpringbootLearningApplication.java", "Java", 0, 0, 0, 0, 9, 0, 5, 14
"d:\java_project\java-learning-travel-demo\springboot-learning\src\main\java\com\wendy\filetransform\download\DownloadController.java", "Java", 0, 0, 0, 0, 72, 22, 8, 102
"d:\java_project\java-learning-travel-demo\springboot-learning\src\main\java\com\wendy\filetransform\upload\common\Result.java", "Java", 0, 0, 0, 0, 19, 6, 9, 34
"d:\java_project\java-learning-travel-demo\springboot-learning\src\main\java\com\wendy\filetransform\upload\controller\UoloadController.java", "Java", 0, 0, 0, 0, 34, 6, 6, 46
"d:\java_project\java-learning-travel-demo\springboot-learning\src\main\java\com\wendy\filetransform\upload\service\UploadService.java", "Java", 0, 0, 0, 0, 8, 18, 4, 30
"d:\java_project\java-learning-travel-demo\springboot-learning\src\main\java\com\wendy\filetransform\upload\service\impl\UploadServiceImpl.java", "Java", 0, 0, 0, 0, 83, 10, 9, 102
"d:\java_project\java-learning-travel-demo\springboot-learning\src\main\java\com\wendy\interceptor\LoginInterceptor.java", "Java", 0, 0, 0, 0, 21, 9, 7, 37
"d:\java_project\java-learning-travel-demo\springboot-learning\src\main\java\com\wendy\interceptor\WebConfigure.java", "Java", 0, 0, 0, 0, 15, 26, 6, 47
"d:\java_project\java-learning-travel-demo\springboot-learning\src\main\java\com\wendy\java_web\cookie\CookieSessionTest.java", "Java", 0, 0, 0, 0, 50, 21, 6, 77
"d:\java_project\java-learning-travel-demo\springboot-learning\src\main\java\com\wendy\java_web\filter\FilterTest.java", "Java", 0, 0, 0, 0, 26, 9, 7, 42
"d:\java_project\java-learning-travel-demo\springboot-learning\src\main\java\com\wendy\java_web\filter\config\FilterConfig.java", "Java", 0, 0, 0, 0, 10, 13, 6, 29
"d:\java_project\java-learning-travel-demo\springboot-learning\src\main\java\com\wendy\java_web\listener\ListenerTest.java", "Java", 0, 0, 0, 0, 3, 6, 2, 11
"d:\java_project\java-learning-travel-demo\springboot-learning\src\main\resources\application.yml", "YAML", 0, 0, 0, 0, 0, 0, 1, 1
"d:\java_project\java-learning-travel-demo\springboot-learning\src\test\java\com\wendy\springbootlearning\SpringbootLearningApplicationTests.java", "Java", 0, 0, 0, 0, 9, 0, 5, 14
"Total", "-", 4, 0, 0, 0, 341, 146, 70, 561