"filename", "language", "XML", "Java Properties", "Batch", "Java", "comment", "blank", "total"
"d:\java_project\java-learning-travel-demo\java-web\.mvn\wrapper\maven-wrapper.properties", "Java Properties", 0, 2, 0, 0, 16, 1, 19
"d:\java_project\java-learning-travel-demo\java-web\mvnw.cmd", "Batch", 0, 0, 102, 0, 51, 36, 189
"d:\java_project\java-learning-travel-demo\java-web\pom.xml", "XML", 38, 0, 0, 0, 0, 4, 42
"d:\java_project\java-learning-travel-demo\java-web\src\main\java\com\wendy\JavaWebApplication.java", "Java", 0, 0, 0, 9, 0, 5, 14
"d:\java_project\java-learning-travel-demo\java-web\src\main\java\com\wendy\config\FilterConfig.java", "Java", 0, 0, 0, 10, 13, 5, 28
"d:\java_project\java-learning-travel-demo\java-web\src\main\java\com\wendy\cookie\CookieSessionTest.java", "Java", 0, 0, 0, 50, 6, 7, 63
"d:\java_project\java-learning-travel-demo\java-web\src\main\java\com\wendy\filter\FilterTest.java", "Java", 0, 0, 0, 26, 9, 7, 42
"d:\java_project\java-learning-travel-demo\java-web\src\main\java\com\wendy\listener\ListenerTest.java", "Java", 0, 0, 0, 3, 6, 2, 11
"d:\java_project\java-learning-travel-demo\java-web\src\main\resources\application.properties", "Java Properties", 0, 0, 0, 0, 0, 2, 2
"d:\java_project\java-learning-travel-demo\java-web\src\test\java\com\wendy\javaweb\JavaWebApplicationTests.java", "Java", 0, 0, 0, 9, 0, 5, 14
"Total", "-", 38, 2, 102, 107, 101, 74, 424