"filename", "language", "XML", "Java Properties", "Batch", "Java", "YAML", "comment", "blank", "total"
"d:\java_project\java-learning-travel-demo\middleware\.mvn\wrapper\maven-wrapper.properties", "Java Properties", 0, -2, 0, 0, 0, -16, -1, -19
"d:\java_project\java-learning-travel-demo\middleware\mvnw.cmd", "Batch", 0, 0, -102, 0, 0, -51, -36, -189
"d:\java_project\java-learning-travel-demo\middleware\pom.xml", "XML", -120, 0, 0, 0, 0, -25, -19, -164
"d:\java_project\java-learning-travel-demo\middleware\src\main\java\com\wendy\MiddlewareApplication.java", "Java", 0, 0, 0, -9, 0, 0, -5, -14
"d:\java_project\java-learning-travel-demo\middleware\src\main\java\com\wendy\elasticsearch\config\ElasticsearchClientConfig.java", "Java", 0, 0, 0, -16, 0, -12, -3, -31
"d:\java_project\java-learning-travel-demo\middleware\src\main\java\com\wendy\elasticsearch\controller\ContentController.java", "Java", 0, 0, 0, -25, 0, -6, -6, -37
"d:\java_project\java-learning-travel-demo\middleware\src\main\java\com\wendy\elasticsearch\dao\CrawlerDao.java", "Java", 0, 0, 0, -31, 0, -13, -6, -50
"d:\java_project\java-learning-travel-demo\middleware\src\main\java\com\wendy\elasticsearch\entity\Content.java", "Java", 0, 0, 0, -8, 0, -6, -5, -19
"d:\java_project\java-learning-travel-demo\middleware\src\main\java\com\wendy\elasticsearch\entity\User.java", "Java", 0, 0, 0, -11, 0, -6, -4, -21
"d:\java_project\java-learning-travel-demo\middleware\src\main\java\com\wendy\elasticsearch\service\ContentService.java", "Java", 0, 0, 0, -61, 0, -16, -7, -84
"d:\java_project\java-learning-travel-demo\middleware\src\main\java\com\wendy\elasticsearch\utils\ESUtils.java", "Java", 0, 0, 0, -7, 0, -6, -4, -17
"d:\java_project\java-learning-travel-demo\middleware\src\main\java\com\wendy\elasticsearch\utils\JSONUtils.java", "Java", 0, 0, 0, -9, 0, -6, -4, -19
"d:\java_project\java-learning-travel-demo\middleware\src\main\java\com\wendy\rabbitmq\acknowledgement\Worker03.java", "Java", 0, 0, 0, -25, 0, -12, -4, -41
"d:\java_project\java-learning-travel-demo\middleware\src\main\java\com\wendy\rabbitmq\acknowledgement\Worker04.java", "Java", 0, 0, 0, -25, 0, -12, -4, -41
"d:\java_project\java-learning-travel-demo\middleware\src\main\java\com\wendy\rabbitmq\deadqueue\Consumer01.java", "Java", 0, 0, 0, -33, 0, -13, -9, -55
"d:\java_project\java-learning-travel-demo\middleware\src\main\java\com\wendy\rabbitmq\deadqueue\Consumer02.java", "Java", 0, 0, 0, -23, 0, -6, -5, -34
"d:\java_project\java-learning-travel-demo\middleware\src\main\java\com\wendy\rabbitmq\deadqueue\Producer.java", "Java", 0, 0, 0, -21, 0, -8, -3, -32
"d:\java_project\java-learning-travel-demo\middleware\src\main\java\com\wendy\rabbitmq\publishConfirm\PublishConfirm.java", "Java", 0, 0, 0, -89, 0, -39, -8, -136
"d:\java_project\java-learning-travel-demo\middleware\src\main\java\com\wendy\rabbitmq\simple\Consumer.java", "Java", 0, 0, 0, -22, 0, -15, -7, -44
"d:\java_project\java-learning-travel-demo\middleware\src\main\java\com\wendy\rabbitmq\simple\Producer.java", "Java", 0, 0, 0, -20, 0, -24, -6, -50
"d:\java_project\java-learning-travel-demo\middleware\src\main\java\com\wendy\rabbitmq\spring\config\RabbitmqConfig.java", "Java", 0, 0, 0, -35, 0, -12, -8, -55
"d:\java_project\java-learning-travel-demo\middleware\src\main\java\com\wendy\rabbitmq\spring\consumer\RabbitmqHandler.java", "Java", 0, 0, 0, -17, 0, -8, -4, -29
"d:\java_project\java-learning-travel-demo\middleware\src\main\java\com\wendy\rabbitmq\spring\controller\ProduceController.java", "Java", 0, 0, 0, -20, 0, -12, -7, -39
"d:\java_project\java-learning-travel-demo\middleware\src\main\java\com\wendy\rabbitmq\workqueue\Producer.java", "Java", 0, 0, 0, -17, 0, -7, -4, -28
"d:\java_project\java-learning-travel-demo\middleware\src\main\java\com\wendy\rabbitmq\workqueue\RabbitMqUtils.java", "Java", 0, 0, 0, -14, 0, -9, -3, -26
"d:\java_project\java-learning-travel-demo\middleware\src\main\java\com\wendy\rabbitmq\workqueue\Worker01.java", "Java", 0, 0, 0, -21, 0, -6, -8, -35
"d:\java_project\java-learning-travel-demo\middleware\src\main\java\com\wendy\redis\jedis\JedisDemo.java", "Java", 0, 0, 0, -23, 0, -6, -5, -34
"d:\java_project\java-learning-travel-demo\middleware\src\main\java\com\wendy\redis\jedis\RedisConfig.java", "Java", 0, 0, 0, -18, 0, -78, -3, -99
"d:\java_project\java-learning-travel-demo\middleware\src\main\resources\application.yml", "YAML", 0, 0, 0, 0, -13, -5, -2, -20
"d:\java_project\java-learning-travel-demo\middleware\src\test\java\com\wendy\elasticsearch\CrawlerTest.java", "Java", 0, 0, 0, -17, 0, -6, -5, -28
"d:\java_project\java-learning-travel-demo\middleware\src\test\java\com\wendy\elasticsearch\ESApplicationoTest.java", "Java", 0, 0, 0, -140, 0, -76, -16, -232
"d:\java_project\java-learning-travel-demo\middleware\src\test\java\com\wendy\middleware\MiddlewareApplicationTests.java", "Java", 0, 0, 0, -9, 0, 0, -5, -14
"d:\java_project\java-learning-travel-demo\springboot-blog\.mvn\wrapper\maven-wrapper.properties", "Java Properties", 0, 2, 0, 0, 0, 16, 1, 19
"d:\java_project\java-learning-travel-demo\springboot-blog\mvnw.cmd", "Batch", 0, 0, 102, 0, 0, 51, 36, 189
"d:\java_project\java-learning-travel-demo\springboot-blog\pom.xml", "XML", 38, 0, 0, 0, 0, 0, 4, 42
"d:\java_project\java-learning-travel-demo\springboot-blog\src\main\java\com\wendy\springbootblog\SpringbootBlogApplication.java", "Java", 0, 0, 0, 9, 0, 0, 5, 14
"d:\java_project\java-learning-travel-demo\springboot-blog\src\main\resources\application.properties", "Java Properties", 0, 0, 0, 0, 0, 0, 2, 2
"d:\java_project\java-learning-travel-demo\springboot-blog\src\test\java\com\wendy\springbootblog\SpringbootBlogApplicationTests.java", "Java", 0, 0, 0, 9, 0, 0, 5, 14
"Total", "-", -82, 0, 0, -748, -13, -450, -163, -1456