"filename", "language", "Java Properties", "YAML", "Java", "XML", "Batch", "comment", "blank", "total"
"d:\java_project\java-learning-travel-demo\java-web\.mvn\wrapper\maven-wrapper.properties", "Java Properties", -2, 0, 0, 0, 0, -16, -1, -19
"d:\java_project\java-learning-travel-demo\java-web\mvnw.cmd", "Batch", 0, 0, 0, 0, -102, -51, -36, -189
"d:\java_project\java-learning-travel-demo\java-web\pom.xml", "XML", 0, 0, 0, -38, 0, 0, -4, -42
"d:\java_project\java-learning-travel-demo\java-web\src\main\java\com\wendy\JavaWebApplication.java", "Java", 0, 0, -9, 0, 0, 0, -5, -14
"d:\java_project\java-learning-travel-demo\java-web\src\main\java\com\wendy\config\FilterConfig.java", "Java", 0, 0, -10, 0, 0, -13, -5, -28
"d:\java_project\java-learning-travel-demo\java-web\src\main\java\com\wendy\cookie\CookieSessionTest.java", "Java", 0, 0, -50, 0, 0, -6, -7, -63
"d:\java_project\java-learning-travel-demo\java-web\src\main\java\com\wendy\filter\FilterTest.java", "Java", 0, 0, -26, 0, 0, -9, -7, -42
"d:\java_project\java-learning-travel-demo\java-web\src\main\java\com\wendy\listener\ListenerTest.java", "Java", 0, 0, -3, 0, 0, -6, -2, -11
"d:\java_project\java-learning-travel-demo\java-web\src\main\resources\application.properties", "Java Properties", 0, 0, 0, 0, 0, 0, -2, -2
"d:\java_project\java-learning-travel-demo\java-web\src\test\java\com\wendy\javaweb\JavaWebApplicationTests.java", "Java", 0, 0, -9, 0, 0, 0, -5, -14
"d:\java_project\java-learning-travel-demo\middleware\.mvn\wrapper\maven-wrapper.properties", "Java Properties", 2, 0, 0, 0, 0, 16, 1, 19
"d:\java_project\java-learning-travel-demo\middleware\mvnw.cmd", "Batch", 0, 0, 0, 0, 102, 51, 36, 189
"d:\java_project\java-learning-travel-demo\middleware\pom.xml", "XML", 0, 0, 0, 120, 0, 25, 19, 164
"d:\java_project\java-learning-travel-demo\middleware\src\main\java\com\wendy\MiddlewareApplication.java", "Java", 0, 0, 9, 0, 0, 0, 5, 14
"d:\java_project\java-learning-travel-demo\middleware\src\main\java\com\wendy\elasticsearch\config\ElasticsearchClientConfig.java", "Java", 0, 0, 16, 0, 0, 12, 3, 31
"d:\java_project\java-learning-travel-demo\middleware\src\main\java\com\wendy\elasticsearch\controller\ContentController.java", "Java", 0, 0, 25, 0, 0, 6, 6, 37
"d:\java_project\java-learning-travel-demo\middleware\src\main\java\com\wendy\elasticsearch\dao\CrawlerDao.java", "Java", 0, 0, 31, 0, 0, 13, 6, 50
"d:\java_project\java-learning-travel-demo\middleware\src\main\java\com\wendy\elasticsearch\entity\Content.java", "Java", 0, 0, 8, 0, 0, 6, 5, 19
"d:\java_project\java-learning-travel-demo\middleware\src\main\java\com\wendy\elasticsearch\entity\User.java", "Java", 0, 0, 11, 0, 0, 6, 4, 21
"d:\java_project\java-learning-travel-demo\middleware\src\main\java\com\wendy\elasticsearch\service\ContentService.java", "Java", 0, 0, 61, 0, 0, 16, 7, 84
"d:\java_project\java-learning-travel-demo\middleware\src\main\java\com\wendy\elasticsearch\utils\ESUtils.java", "Java", 0, 0, 7, 0, 0, 6, 4, 17
"d:\java_project\java-learning-travel-demo\middleware\src\main\java\com\wendy\elasticsearch\utils\JSONUtils.java", "Java", 0, 0, 9, 0, 0, 6, 4, 19
"d:\java_project\java-learning-travel-demo\middleware\src\main\java\com\wendy\rabbitmq\acknowledgement\Worker03.java", "Java", 0, 0, 25, 0, 0, 12, 4, 41
"d:\java_project\java-learning-travel-demo\middleware\src\main\java\com\wendy\rabbitmq\acknowledgement\Worker04.java", "Java", 0, 0, 25, 0, 0, 12, 4, 41
"d:\java_project\java-learning-travel-demo\middleware\src\main\java\com\wendy\rabbitmq\deadqueue\Consumer01.java", "Java", 0, 0, 33, 0, 0, 13, 9, 55
"d:\java_project\java-learning-travel-demo\middleware\src\main\java\com\wendy\rabbitmq\deadqueue\Consumer02.java", "Java", 0, 0, 23, 0, 0, 6, 5, 34
"d:\java_project\java-learning-travel-demo\middleware\src\main\java\com\wendy\rabbitmq\deadqueue\Producer.java", "Java", 0, 0, 21, 0, 0, 8, 3, 32
"d:\java_project\java-learning-travel-demo\middleware\src\main\java\com\wendy\rabbitmq\publishConfirm\PublishConfirm.java", "Java", 0, 0, 89, 0, 0, 39, 8, 136
"d:\java_project\java-learning-travel-demo\middleware\src\main\java\com\wendy\rabbitmq\simple\Consumer.java", "Java", 0, 0, 22, 0, 0, 15, 7, 44
"d:\java_project\java-learning-travel-demo\middleware\src\main\java\com\wendy\rabbitmq\simple\Producer.java", "Java", 0, 0, 20, 0, 0, 24, 6, 50
"d:\java_project\java-learning-travel-demo\middleware\src\main\java\com\wendy\rabbitmq\spring\config\RabbitmqConfig.java", "Java", 0, 0, 35, 0, 0, 12, 8, 55
"d:\java_project\java-learning-travel-demo\middleware\src\main\java\com\wendy\rabbitmq\spring\consumer\RabbitmqHandler.java", "Java", 0, 0, 17, 0, 0, 8, 4, 29
"d:\java_project\java-learning-travel-demo\middleware\src\main\java\com\wendy\rabbitmq\spring\controller\ProduceController.java", "Java", 0, 0, 20, 0, 0, 12, 7, 39
"d:\java_project\java-learning-travel-demo\middleware\src\main\java\com\wendy\rabbitmq\workqueue\Producer.java", "Java", 0, 0, 17, 0, 0, 7, 4, 28
"d:\java_project\java-learning-travel-demo\middleware\src\main\java\com\wendy\rabbitmq\workqueue\RabbitMqUtils.java", "Java", 0, 0, 14, 0, 0, 9, 3, 26
"d:\java_project\java-learning-travel-demo\middleware\src\main\java\com\wendy\rabbitmq\workqueue\Worker01.java", "Java", 0, 0, 21, 0, 0, 6, 8, 35
"d:\java_project\java-learning-travel-demo\middleware\src\main\java\com\wendy\redis\jedis\JedisDemo.java", "Java", 0, 0, 23, 0, 0, 6, 5, 34
"d:\java_project\java-learning-travel-demo\middleware\src\main\java\com\wendy\redis\jedis\RedisConfig.java", "Java", 0, 0, 18, 0, 0, 78, 3, 99
"d:\java_project\java-learning-travel-demo\middleware\src\main\resources\application.yml", "YAML", 0, 13, 0, 0, 0, 5, 2, 20
"d:\java_project\java-learning-travel-demo\middleware\src\test\java\com\wendy\elasticsearch\CrawlerTest.java", "Java", 0, 0, 17, 0, 0, 6, 5, 28
"d:\java_project\java-learning-travel-demo\middleware\src\test\java\com\wendy\elasticsearch\ESApplicationoTest.java", "Java", 0, 0, 140, 0, 0, 76, 16, 232
"d:\java_project\java-learning-travel-demo\middleware\src\test\java\com\wendy\middleware\MiddlewareApplicationTests.java", "Java", 0, 0, 9, 0, 0, 0, 5, 14
"Total", "-", 0, 13, 659, 82, 0, 416, 142, 1312